31 31																														
940 980	
4																													
5 5 5 5 5 5 5 5 5 5 5 5 5 5 5 5 5 5 5 5 5 5 5 5 5 5 5 5 5 5 5 
5 5 5 5 10 5 5 5 11 5 5 5 10 5 5 5 5 5 5 10 5 5 5 5 5 5 5 5 5 5 5
5 5 12 13 13 13 13 13 13 13 13 13 12 5 5 5 5 5 5 11 5 5 5 11 5 5 5 5 5 5 5
5 5 13 34 27 27 27 27 27 27 27 32 13 5 5 5 5 5 5 5 5 5 5 5 5 5 5 5 5 5 5  
5 5 13 30 8 8 8 8 8 8 8 28 13 5 5 5 5 5 5 5 5 8 8 8 8 8 8 5 5 5 5  
5 5 13 30 8 8 8 8 8 8 8 28 13 5 5 5 5 5 5 5 5 8 2 2 2 5 8 5 5 5 5  
5 5 13 30 8 8 8 8 8 8 8 28 13 5 5 5 10 5 5 5 5 8 2 3 2 5 8 5 5 5 5  
5 5 13 30 8 8 8 8 8 8 8 28 13 5 5 5 11 5 5 5 5 8 8 8 5 5 8 5 5 5 5  
5 5 13 30 8 8 8 8 8 8 8 28 13 5 5 5 5 5 5 5 5 5 5 5 5 5 8 5 5 5 5  
5 5 13 30 8 8 8 8 8 8 8 28 13 5 5 5 5 5 5 5 5 5 5 5 5 5 8 5 5 5 5  
5 5 13 35 29 29 29 29 8 29 29 33 13 5 5 5 5 5 5 5 5 5 5 5 5 5 8 5 5 5 5  
5 5 12 13 13 13 13 13 8 13 13 13 12 5 5 5 5 5 5 5 5 5 5 5 5 5 8 5 5 5 5  
5 5 5 5 5 5 5 5 8 5 5 5 34 27 27 27 27 27 32 5 5 5 5 5 5 5 8 5 5 5 5  
5 5 5 5 5 5 5 5 8 5 5 5 30 8 8 8 8 8 28 5 5 5 5 5 5 5 8 5 5 5 5  
5 5 5 10 5 5 5 5 8 5 5 5 30 8 2 2 2 8 28 5 5 5 5 5 5 5 8 5 5 5 5  
5 5 5 5 11 5 5 5 8 5 5 5 30 8 2 4 2 8 28 5 5 5 5 5 5 5 8 5 5 5 5  
5 5 5 5 5 5 5 5 8 5 5 5 30 8 8 8 8 8 28 5 5 5 5 5 5 5 8 5 5 5 5  
5 5 5 5 5 5 5 5 8 5 5 5 35 29 8 29 29 29 33 5 5 5 5 5 5 5 8 5 5 5 5  
5 5 5 5 5 5 5 34 8 27 27 27 27 32 8 5 5 5 5 5 5 5 5 5 5 5 8 5 5 5 5  
5 5 5 5 5 5 5 30 8 8 8 8 8 8 8 8 8 8 8 8 8 5 5 5 5 5 8 5 5 5 5  
5 5 5 5 11 5 5 30 8 8 8 8 8 28 5 5 5 5 5 5 8 5 5 5 5 5 8 5 5 5 5  
5 5 5 10 5 5 5 30 8 8 8 8 8 28 5 5 5 11 10 5 8 5 5 5 5 5 8 5 5 5 5  
5 5 5 5 5 5 5 35 29 29 8 29 29 33 5 5 5 5 5 5 8 5 5 5 5 5 8 5 5 5 5  
5 5 5 5 5 10 5 5 5 5 8 5 5 5 5 5 5 5 5 5 8 8 8 8 8 8 8 5 5 5 5  
5 5 5 5 5 5 5 5 5 5 8 5 5 5 5 5 5 5 5 5 5 5 5 5 5 5 5 5 5 5 5  
5 5 5 34 27 27 27 27 27 27 8 27 32 5 5 5 5 5 5 5 5 5 5 5 5 5 5 5 5 5 5  
5 5 5 30 8 8 8 8 8 8 8 8 28 5 5 5 5 5 5 5 5 5 5 5 5 5 5 5 5 5 5  
5 5 5 30 8 8 8 8 8 8 8 8 28 5 5 5 5 5 5 10 5 11 5 5 5 5 5 5 5 5 5  
5 5 5 30 8 8 8 8 8 8 8 8 28 5 5 5 5 5 5 11 5 5 5 5 5 5 5 5 5 5 5  
5 5 5 30 8 8 8 8 8 8 8 8 28 5 5 5 5 5 5 5 5 5 5 5 5 10 5 5 5 5 5  
5 5 5 35 29 29 29 29 29 29 29 29 33 5 5 5 5 5 5 5 5 5 5 5 5 5 5 5 5 5 5   

