31 31																														
970 1000
5																														
9 9 9 9 9 9 9 9 9 9 9 9 9 9 9 9 9 9 9 9 2 2 2 9 9 9 9 9 9 9 9 
9 9 9 9 9 9 9 9 9 9 9 9 9 9 9 9 9 9 9 9 2 3 2 9 9 9 9 9 9 9 9 
9 9 9 9 9 9 9 9 9 9 9 9 9 9 9 9 9 9 9 9 2 18 2 9 9 9 9 9 9 9 9  
9 9 9 9 9 9 9 9 9 9 9 9 9 9 9 2 2 2 2 2 2 18 2 9 9 9 9 9 9 9 9 
9 9 9 9 9 9 9 9 9 9 9 9 9 9 9 2 18 18 18 18 18 18 2 9 9 9 9 9 9 9 9 
9 9 9 9 2 2 2 2 2 2 2 2 2 9 9 2 18 18 18 18 18 18 2 9 9 9 9 9 9 9 9 
9 9 9 9 2 16 16 16 16 16 16 16 2 9 9 2 18 18 18 18 18 18 2 9 9 9 9 9 9 9 9 
9 9 9 9 2 16 17 17 17 17 17 16 2 9 9 2 18 18 18 18 18 18 2 9 9 9 9 9 9 9 9 
9 9 9 9 2 16 17 9 9 9 17 16 2 9 9 2 18 18 18 18 18 18 2 9 9 9 9 9 9 9 9 
9 9 9 9 2 16 17 9 20 9 17 16 2 9 9 2 18 18 18 18 18 18 2 9 9 9 9 9 9 9 9 
9 9 9 2 2 16 17 9 9 9 9 9 9 9 9 2 18 18 18 18 18 18 2 2 2 9 9 9 9 9 9
9 9 9 2 18 18 17 17 17 17 17 16 2 2 2 2 18 18 18 18 18 18 18 18 2 2 9 9 9 9 9
9 9 9 2 18 18 18 18 18 18 18 18 18 18 18 18 18 18 18 18 18 18 18 18 18 2 2 9 9 9 9
9 9 9 2 2 2 2 18 18 18 18 18 18 18 18 18 18 18 18 18 18 18 18 18 18 18 2 2 9 9 9
9 9 9 9 9 9 2 18 18 18 18 18 18 18 2 2 2 18 18 18 18 18 18 18 18 18 18 2 2 9 9
9 9 9 9 9 9 2 18 18 18 18 18 18 18 2 4 2 18 18 18 18 18 18 18 18 18 18 18 2 2 9
9 9 9 9 9 9 2 18 18 18 18 18 18 18 18 18 18 18 18 18 18 18 18 18 18 18 18 18 18 2 9
9 9 9 9 9 9 2 18 18 18 18 18 18 18 18 18 18 18 18 18 18 18 18 18 18 18 18 18 18 2 9
9 9 9 9 9 9 2 2 2 2 2 18 18 18 18 18 18 18 18 18 18 18 18 18 18 18 18 18 18 2 9
9 9 9 9 9 9 9 9 9 9 2 18 18 18 18 18 18 18 18 18 18 18 18 18 18 18 18 18 18 2 9
9 9 9 9 9 9 9 9 9 9 2 18 18 18 18 18 18 18 2 2 2 2 2 2 18 18 18 18 18 2 9
9 9 9 9 9 9 9 9 9 9 2 18 18 18 18 18 18 18 2 9 9 9 9 2 18 18 18 18 18 2 9
9 9 9 9 9 9 9 9 9 9 2 18 18 18 18 18 18 18 2 2 2 2 2 2 18 18 18 18 18 2 9
9 9 9 9 9 9 9 9 9 9 2 18 18 18 18 18 18 18 18 18 18 18 18 2 2 2 2 2 2 2 9
9 9 9 9 9 9 9 9 9 9 2 2 2 2 2 2 2 2 2 18 18 18 18 2 9 9 9 9 9 9 9
9 9 9 9 9 9 17 17 17 17 17 9 14 9 9 9 9 2 2 18 18 18 18 2 2 2 9 9 9 9 9
9 9 9 9 9 17 14 14 17 17 14 14 14 9 9 2 2 2 18 18 18 18 18 18 18 2 2 9 9 9 9 9
9 9 9 9 9 14 14 18 15 18 14 14 14 9 2 2 18 18 18 18 18 18 18 18 18 18 2 2 9 9 9
9 9 9 9 9 14 14 18 17 18 14 14 14 14 2 18 18 18 18 18 18 18 18 18 18 18 18 2 9 9 9
9 9 9 9 9 14 14 14 9 14 14  9 9 2 2 2 2 2 2 2 2 2 2 2 2 2 2 9 9 9
9 9 9 9 9 9 9 9 9 9 9 9 9 9 9 9 9 9 9 9 9 9 9 9 9 9 9 9 9 9 9
